000000000000000000000000000000000000000000000000000000000000
000000000000000000011111111110000000000000000000000000000000
044444444444111111112222222210000000000000000000000000000000
042222222224333333332222222210001111111111110000111111111100
042222222224333333332222222210001222222222210000122222222100
042222222224333333332222222210001222222222210000122222222100
042222222224222222232222222210001222222222211111122222222100
042228282224222222232222222210001222222222222222222222222100
042222222224222222232222222211111222222222222222222222222100
042222222224222222232222222233333222222222222222222222222100
042222222224223333333333333333333222222222222222222222222100
042222222224223333333322333333333333331111111122222222222100
044444544444223333333322332222222223333122222122222222222100
000001333333223222223322332222222223333122222122222222222100
000001133333223222223322333333333333333622222622222222222100
000000133333223222223322333333333333333622222622222222222100
000000122222222222223322333333333333333122222122222222222100
000000122222222222223322333333333333333122222122222222222100
000000122222222222223322111111111111111111111122222222222100
000000122222222222223322222222222222222222333122222222222100
000000122222222333333322222222222222222222333111111111111100
000111122222222333333322333333333333332223366661111111111111
000122222222222333333333333333333333332223362222222222222221
000122222222222223333333333333333333332223362222222222222221
000122233333322223333322222133322222332223362222222222222221
000122233333322222222222222133322222332223362222222222222221
000122233333322222222222222133322222332223362222222222222221
000122233333322223333322222133322222111111112222222222222221
000122233331122223333322222222222222100000012222222222222221
111133311111122223333322222222222222100000012222222222222221
122222222210122223333322222222222222100000012222222222222221
122222222210122222222222222222222222100000012222222222222221
122222222210122222222222222222222222100000012222222222222221
122222222210122222222222222111122222100000012222222222222221
122222222210111111111122222100122222100000012222222222222221
122222222210000000000122222100122222100000012222222222222221
122222222210000000000122222100122222100000012222222222272221
122222222210000000000122222100122222100000012222222222222221
122222222210000000000111111100111111100000012222222222222221
111111111110000000000000000000000000000000011111111111111111

